111111111111111111111
1P0001111100001000001
1000010N010000100C001
11000000100010E111111
100000011100001110011
100000C0000C000011111
111111111111111111111
