1111111111111
1C0000000C001
10000C1111001
1P001100C00E1
1111111111111
