111111111111111
1C0000000C00001
10000C000000001
1P000000C0000E1
100C000000C0001
100000C000000C1
111111111111111
