1111111111111111111111111111
10000010000000000C0000000001
100000100N000000000000000001
1000C01000000000000000000001
100000100000C0000000C000NE01
1000001000N00000000000000001
10000010000000P00000N0000001
100C001000000000000000000001
1111111111111111111111111111
