1111111111111111111111111111
100000N0000000000C0000000001
1000000000000000000000000001
1000000000000000000000000001
100000100000C000000000000E01
1000001000000000000000000001
10000010000000P0000000000001
100C001000000000000000000001
1111111111111111111111111111
