1111111111111111111111111111
100000N0000000000C0000000001
100000000N000000000000000001
1000000000000000000000000001
100000100000C00000000000NE01
1000001000N00000000000000001
10000010000000P00000N0000001
100C001000000000000000000001
1111111111111111111111111111
