1111111111111
1P1000000C001
1000C11111001
10101100C00E1
1111111111111
