1111111111111111111111111111
100000N000000000000000000001
1000000000000000000000000001
1000000000000000000000000001
100000000000C000000000000E01
1000000000000000000000000001
1000000000000000000000000001
1000000P00000000000000000001
1111111111111111111111111111
