11111111111111111111111111111
1E0000000010000C10000C0000001
10000101101010001010010010101
10000100101011111010010010101
1P00010C1000C000000000000N0C1
10000000000000010000000000001
10C00100000N00010000010011111
10000100000C0001000001000C001
11111111111111111111111111111
