111111111111111
100000000001E01
100010000001001
1P001000C001011
100010000000001
100C1000000C001
111111111111111
