111111111111111
100N0000001E011
100000000001001
1P00100NC001011
100010000000001
100C100NN00C001
111111111111111
