111111111111111
100000000000001
1000001N1000001
1000000P0000001
1000000000000E1
100000C0000C001
111111111111111
