111111111111111111111
100000000000000000001
1000000N000000000E001
1000000P0000000000001
100000000000000000001
100000C0000C000000001
111111111111111111111
