111111111111111111111
10000000000C000000001
100000000000000000001
1P00000000000000000E1
100000000000000000001
100000C00000000C00001
111111111111111111111
