111111111111111111111
1P0001111100001000001
1000010NE10000100C001
100001000100001000001
100000011100001110111
100000C0000C000000001
111111111111111111111
