11111111111111111111111111111
1E0000000010000C10000C0000001
10100101101010001010010010101
10100100101011111010010010101
1P00010C10N0C00000000000000C1
10000000000000010000000000001
10C00100000000010000010011111
10000100000C0001000001000C001
11111111111111111111111111111